R 1000 1000
NO ./textur/alpha.xpm
SO ./textur/brick.xpm
WE ./textur/frensh.xpm
EA ./textur/ilusion.xpm
S ./textur/star.xpm
F 255,0,0
C 0,255,0

11111111111111111111111111111
10110020011100000000000010001
10010000000000000000000010001
110000N0000010111000000100011
11000000000001011100000010001
10000020000000000000000000001
10000000000000000000000000001
11110101111101011111011110001
111111111 1111111111111111111
