R 1000 1000
NO ./textur/alpha.xpm
SO ./textur/brick.xpm
WE ./textur/frensh.xpm
EA ./textur/ilusion.xpm
S ./textur/star.xpm
F 123,241,0
C 154,124,255

11111111111111111111111111111
10110020011100000000000010001
10010000001100000000000010001
111100N0011110111000000100011
11001000110101011100000010001
10000000000000000000000000001
10000000000000000000000000001
11110101111101011111011110001
111111111 1111111111111111111
