F 255, 0, 0
NO ./textur/north.xpm
SO ./textur/south.xpm
WE ./textur/west.xpm
EA ./textur/east.xpm
S  ./textur/sonic.xpm
C 255, 0, 0
R 500 500
                  1
111111111111111111011111
1011010000000000000000001
1001000000200000001000111
1000000000N00000000000001
1000000000000000000000001
1111100000000010111011111
11111111111111111111111111
