F 255, 0, 0
NO ./textur/north.xpm
SO ./textur/south.xpm
WE ./textur/west.xpm
EA ./textur/east.xpm
S  ./textur/sonic.xpm
C 255, 0, 0
R 500 500
                  1
11111111111111111101111111111
10110100011100000000000010001
1001020000N000000000001000111
10000000000000000000000000001
11110101111101011110110111011111
111111111111111111111111111111111
