F 255, 255, 0
SO ./textur/north.xpm
NO ./textur/south.xpm
WE ./textur/west.xpm
EA ./textur/east.xpm
S  ./textur/sonic.xpm
C 255, 0, 0
R 500 500
                  1
1111111111111111110111111
1011010000000000000000001
1001000000200000001000111
10000000000000000000000011
100000000000000000000000001
11111000000000101110111111
11111111111011111111111111
1          1
1
1111111111111111111
1000000000N00000001
1111111111111111111
